01,01,01,01,01,01,01,02
04,04,04,04,08,09,04,04
01,01,01,01,03,01,01,01
10,10,10,00,10,10,10,10
11,11,11,11,00,11,11,11
12,12,12,12,12,00,12,12
13,13,13,13,13,13,00,13
00,14,14,14,14,14,14,14
15,15,15,15,15,15,15,00
05,04,04,04,04,07,04,04
04,04,04,06,16,01,01,01
01,01,01,01,17,01,01,01
