01,01,01,01,01,03,03,01
01,01,00,01,01,04,04,04
00,04,04,04,04,04,04,04
04,04,04,01,01,01,01,01
01,00,00,01,00,00,01,00
00,00,00,00,00,00,01,00
01,01,00,01,01,00,01,01
08,09,08,09,08,09,08,09
01,01,01,01,00,00,00,00
00,00,01,01,00,01,01,00
14,14,14,14,15,15,15,15
10,10,10,10,10,10,10,10
