04,06,00,05,04,04,04,04
06,00,05,04,18,04,04,06
00,00,00,00,00,00,00,00
00,00,00,00,00,00,00,00
00,00,00,00,00,00,00,00
00,00,00,00,00,00,00,00
00,00,00,00,00,00,00,00
00,00,00,00,00,00,00,00
00,00,00,00,00,00,00,00
00,00,00,00,00,00,00,00
00,00,00,00,00,00,00,00
00,00,00,00,00,00,00,00
