05,04,07,08,09,04,06,00
05,04,04,08,09,08,09,08
09,08,09,08,09,08,09,04
04,04,04,04,04,07,04,04
04,04,04,04,04,06,00,05
06,00,05,06,00,05,06,00
05,04,04,04,04,08,09,04
08,09,04,08,09,04,07,04
04,04,04,04,04,04,04,06
00,05,04,04,04,04,04,06
00,05,08,09,08,09,08,09
08,09,04,04,18,04,04,06
