0,1,1,2,1,2,1,2,1,2,1,2,1,3,2,4,
5,6,6,7,6,7,6,7,6,7,6,7,6,7,7,8,
9,10,11,12,10,13,11,12,10,13,11,12,10,13,12,14,
15,16,17,18,15,16,17,18,15,16,17,18,15,16,17,18,
19,20,21,22,19,20,21,22,19,20,21,22,19,20,21,22,
21,21,20,21,21,21,20,21,21,21,20,21,21,21,20,21,
