0,1,2,3,4,5,6,7,8,9,10,11,12,13,14,15,
16,17,18,19,20,21,22,23,24,25,26,27,28,29,30,31,
32,33,34,35,36,37,38,39,40,41,42,43,44,45,46,47,
48,49,50,51,52,53,54,55,56,57,58,59,60,61,62,63,
64,65,66,0,64,65,66,0,67,68,69,62,70,71,72,0,
73,74,75,76,77,74,78,79,80,74,81,82,83,84,85,86,
87,88,89,90,91,88,89,92,91,88,89,92,93,94,95,96,
70,71,72,0,97,98,99,62,64,100,66,0,64,101,66,0,
102,84,103,104,105,84,106,107,73,108,75,76,73,109,75,76,
93,94,95,110,93,94,95,110,111,112,113,114,111,112,113,114,
115,116,117,118,119,120,121,122,123,124,119,120,121,122,123,124,
125,126,126,127,128,126,126,126,129,130,128,126,126,126,129,130,
131,132,133,0,134,135,136,137,138,139,134,135,136,137,138,139,
140,140,140,140,140,140,140,140,140,140,140,140,140,140,140,140,
141,142,143,144,145,146,143,144,145,146,143,144,145,146,143,144,
147,148,149,150,151,152,153,150,151,152,153,150,151,152,153,150,
0,0,154,155,156,157,158,155,156,157,158,155,156,157,158,155,
0,0,147,159,160,161,162,163,164,161,162,163,164,161,162,163,
0,0,0,0,165,146,143,144,145,146,143,144,145,146,143,144,
0,0,0,0,166,152,153,150,151,152,153,150,151,152,153,150,
0,0,0,0,167,157,158,155,156,157,158,155,156,157,158,155,
0,0,0,0,168,161,169,170,164,161,169,170,164,161,169,170,
171,171,171,171,172,173,174,175,176,173,174,175,176,173,174,175,
177,178,178,179,178,179,178,179,178,179,178,179,178,180,179,181,
182,183,183,184,183,184,183,184,183,184,183,184,183,184,184,185,
186,187,188,189,187,190,188,189,187,190,188,189,187,190,189,191,
192,193,194,195,192,193,194,195,192,193,194,195,192,193,194,195,
0,0,0,0,0,196,197,198,199,200,0,0,0,0,0,0,
0,0,0,0,201,202,203,204,205,206,207,198,0,0,0,0,
0,0,0,0,208,209,210,211,212,213,214,215,0,0,0,0,
0,0,0,0,216,217,218,219,220,221,222,223,0,0,0,0,
0,0,0,0,0,0,224,225,0,0,0,0,0,0,0,0,
0,0,0,0,0,0,224,225,0,0,0,0,0,0,0,0,
0,0,0,0,0,0,224,225,0,0,0,0,0,0,0,0,
0,0,0,0,0,0,224,225,0,0,0,0,0,0,0,0,
0,0,0,0,0,0,226,227,0,0,0,0,0,0,0,0,
0,0,0,0,0,0,228,229,0,0,0,0,0,0,0,0,
