0,1,2,3,4,5,0,0,
6,7,8,9,10,11,12,3,
13,14,15,16,17,18,19,20,
21,22,23,24,25,26,27,28,
0,0,29,30,0,0,0,0,
0,0,29,30,0,0,0,0,
0,0,29,30,0,0,0,0,
0,0,29,30,0,0,0,0,
0,0,31,32,0,0,0,0,
0,0,33,34,0,0,0,0,
