00,15,15,05,04,04,04,04
04,04,08,09,04,04,04,04
04,04,07,04,04,06,00,00
05,08,09,08,09,08,09,08
09,08,09,08,09,07,09,08
09,08,09,08,09,06,00,00
00,00,00,00,00,00,00,00
02,00,00,10,00,00,00,00
00,00,00,00,00,00,00,00
10,00,00,00,00,00,00,00
00,00,00,00,00,02,00,00
00,00,00,00,00,00,00,00
